project_name	project_key	project_group
Abkhazian Wikipedia	abwiki	meaf_wps
Achinese Wikipedia	acewiki	asia_wps
Adyghe Wikipedia	adywiki	cee_wps
Afrikaans Wikipedia	afwiki	meaf_wps
Afrikaans Wiktionary	afwiktionary	meaf_wps
Akan Wikipedia	akwiki	meaf_wps
Albanian Wikipedia	sqwiki	cee_wps
Albanian Wikiquote	sqwikiquote	cee_wps
Albanian Wiktionary	sqwiktionary	cee_wps
Alemannisch Wikipedia	alswiki	weur_wps
Altai Wikipedia	altwiki	cee_wps
Amharic Wikipedia	amwiki	meaf_wps
Amharic Wiktionary	amwiktionary	meaf_wps
Amis Wikipedia	amiwiki	asia_wps
Arabic Wikibooks	arwikibooks	meaf_wps
Arabic Wikinews	arwikinews	meaf_wps
Arabic Wikipedia	arwiki	arwiki
Arabic Wikiquote	arwikiquote	meaf_wps
Arabic Wikisource	arwikisource	meaf_wps
Arabic Wikiversity	arwikiversity	meaf_wps
Arabic Wiktionary	arwiktionary	meaf_wps
Aragonese Wikipedia	anwiki	weur_wps
Aragonese Wiktionary	anwiktionary	weur_wps
Aramaic Wikipedia	arcwiki	meaf_wps
Armenian Wikipedia	hywiki	meaf_wps
Armenian Wikiquote	hywikiquote	meaf_wps
Armenian Wikisource	hywikisource	meaf_wps
Armenian Wiktionary	hywiktionary	meaf_wps
Aromanian Wikipedia	roa_rupwiki	cee_wps
Arpitan Wikipedia	frpwiki	weur_wps
Assamese Wikipedia	aswiki	sasia_wps
Assamese Wikisource	aswikisource	sasia_wps
Asturian Wikipedia	astwiki	weur_wps
Asturian Wiktionary	astwiktionary	weur_wps
Atayal Wikipedia	taywiki	asia_wps
Atikamekw Wikipedia	atjwiki	other
Avaric Wikipedia	avwiki	cee_wps
Awadhi Wikipedia	awawiki	sasia_wps
Aymara Wikipedia	aywiki	other
Aymara Wiktionary	aywiktionary	other
Azerbaijani Wikibooks	azwikibooks	meaf_wps
Azerbaijani Wikipedia	azwiki	meaf_wps
Azerbaijani Wikiquote	azwikiquote	meaf_wps
Azerbaijani Wikisource	azwikisource	meaf_wps
Azerbaijani Wiktionary	azwiktionary	meaf_wps
Balinese Wikipedia	banwiki	asia_wps
Balinese Wikisource	banwikisource	asia_wps
Bambara Wikipedia	bmwiki	meaf_wps
Banjar Wikipedia	bjnwiki	asia_wps
Basa Banyumasan Wikipedia	map_bmswiki	asia_wps
Bashkir Wikibooks	bawikibooks	cee_wps
Bashkir Wikipedia	bawiki	cee_wps
Basque Wikibooks	euwikibooks	weur_wps
Basque Wikipedia	euwiki	weur_wps
Basque Wikiquote	euwikiquote	weur_wps
Basque Wikisource	euwikisource	weur_wps
Basque Wiktionary	euwiktionary	weur_wps
Bavarian Wikipedia	barwiki	weur_wps
Belarusian (Tara≈°kievica) Wikipedia	be_x_oldwiki	cee_wps
Belarusian Wikipedia	bewiki	cee_wps
Belarusian Wikiquote	bewikiquote	cee_wps
Belarusian Wikisource	bewikisource	cee_wps
Belarusian Wiktionary	bewiktionary	cee_wps
Bengali Wikibooks	bnwikibooks	sasia_wps
Bengali Wikipedia	bnwiki	sasia_wps
Bengali Wikisource	bnwikisource	sasia_wps
Bengali Wikivoyage	bnwikivoyage	sasia_wps
Bengali Wiktionary	bnwiktionary	sasia_wps
Bhojpuri Wikipedia	bhwiki	sasia_wps
Bikol Central Wikipedia	bclwiki	asia_wps
Bishnupriya Wikipedia	bpywiki	asia_wps
Bislama Wikipedia	biwiki	asia_wps
Bosnian Wikibooks	bswikibooks	cee_wps
Bosnian Wikipedia	bswiki	cee_wps
Bosnian Wikiquote	bswikiquote	cee_wps
Bosnian Wiktionary	bswiktionary	cee_wps
Breton Wikipedia	brwiki	weur_wps
Breton Wikiquote	brwikiquote	weur_wps
Breton Wikisource	brwikisource	weur_wps
Breton Wiktionary	brwiktionary	weur_wps
Buginese Wikipedia	bugwiki	asia_wps
Bulgarian Wikibooks	bgwikibooks	cee_wps
Bulgarian Wikipedia	bgwiki	cee_wps
Bulgarian Wikiquote	bgwikiquote	cee_wps
Bulgarian Wiktionary	bgwiktionary	cee_wps
Burmese Wikipedia	mywiki	asia_wps
Burmese Wiktionary	mywiktionary	asia_wps
Buryat Wikipedia	bxrwiki	asia_wps
Cantonese Wikipedia	zh_yuewiki	asia_wps
Catalan Wikibooks	cawikibooks	weur_wps
Catalan Wikinews	cawikinews	weur_wps
Catalan Wikipedia	cawiki	weur_wps
Catalan Wikiquote	cawikiquote	weur_wps
Catalan Wikisource	cawikisource	weur_wps
Catalan Wiktionary	cawiktionary	weur_wps
Cebuano Wikipedia	cebwiki	asia_wps
Central Bikol Wiktionary	bclwiktionary	asia_wps
Central Kurdish Wikipedia	ckbwiki	meaf_wps
Chamorro Wikipedia	chwiki	asia_wps
Chavacano de Zamboanga Wikipedia	cbk_zamwiki	asia_wps
Chechen Wikipedia	cewiki	cee_wps
Cherokee Wikipedia	chrwiki	other
Cheyenne Wikipedia	chywiki	other
Chinese Wikibooks	zhwikibooks	asia_wps
Chinese Wikinews	zhwikinews	asia_wps
Chinese Wikipedia	zhwiki	zhwiki
Chinese Wikiquote	zhwikiquote	asia_wps
Chinese Wikisource	zhwikisource	asia_wps
Chinese Wikiversity	zhwikiversity	asia_wps
Chinese Wikivoyage	zhwikivoyage	asia_wps
Chinese Wiktionary	zhwiktionary	asia_wps
Church Slavic Wikipedia	cuwiki	cee_wps
Chuvash Wikipedia	cvwiki	cee_wps
Classical Chinese Wikipedia	zh_classicalwiki	asia_wps
Colognian Wikipedia	kshwiki	weur_wps
Cornish Wikipedia	kwwiki	weur_wps
Corsican Wikipedia	cowiki	weur_wps
Corsican Wiktionary	cowiktionary	weur_wps
Cree Wikipedia	crwiki	other
Crimean Tatar Wikipedia	crhwiki	cee_wps
Croatian Wikipedia	hrwiki	cee_wps
Croatian Wikiquote	hrwikiquote	cee_wps
Croatian Wikisource	hrwikisource	cee_wps
Croatian Wiktionary	hrwiktionary	cee_wps
Czech Wikibooks	cswikibooks	cee_wps
Czech Wikinews	cswikinews	cee_wps
Czech Wikipedia	cswiki	cee_wps
Czech Wikiquote	cswikiquote	cee_wps
Czech Wikisource	cswikisource	cee_wps
Czech Wikiversity	cswikiversity	cee_wps
Czech Wiktionary	cswiktionary	cee_wps
Dagbani Wikipedia	dagwiki	meaf_wps
Danish Wikibooks	dawikibooks	weur_wps
Danish Wikipedia	dawiki	weur_wps
Danish Wikisource	dawikisource	weur_wps
Danish Wiktionary	dawiktionary	weur_wps
Dinka Wikipedia	dinwiki	meaf_wps
Divehi Wikipedia	dvwiki	asia_wps
Doteli Wikipedia	dtywiki	sasia_wps
Dutch Wikibooks	nlwikibooks	weur_wps
Dutch Wikinews	nlwikinews	weur_wps
Dutch Wikipedia	nlwiki	nlwiki
Dutch Wikiquote	nlwikiquote	weur_wps
Dutch Wikisource	nlwikisource	weur_wps
Dutch Wikivoyage	nlwikivoyage	weur_wps
Dutch Wiktionary	nlwiktionary	weur_wps
Dzongkha Wikipedia	dzwiki	asia_wps
Eastern Mari Wikipedia	mhrwiki	cee_wps
Egyptian Arabic Wikipedia	arzwiki	meaf_wps
Emiliano-Romagnolo Wikipedia	emlwiki	weur_wps
English Wikibooks	enwikibooks	other
English Wikinews	enwikinews	other
English Wikipedia	enwiki	enwiki
English Wikiquote	enwikiquote	other
English Wikisource	enwikisource	other
English Wikiversity	enwikiversity	other
English Wikivoyage	enwikivoyage	other
English Wiktionary	enwiktionary	other
Erzya Wikipedia	myvwiki	cee_wps
Esperanto Wikinews	eowikinews	weur_wps
Esperanto Wikipedia	eowiki	weur_wps
Esperanto Wikiquote	eowikiquote	weur_wps
Esperanto Wikisource	eowikisource	weur_wps
Esperanto Wikivoyage	eowikivoyage	weur_wps
Esperanto Wiktionary	eowiktionary	weur_wps
Estonian Wikibooks	etwikibooks	cee_wps
Estonian Wikipedia	etwiki	cee_wps
Estonian Wikiquote	etwikiquote	cee_wps
Estonian Wiktionary	etwiktionary	cee_wps
Ewe Wikipedia	eewiki	meaf_wps
Extremaduran Wikipedia	extwiki	weur_wps
Faroese Wikipedia	fowiki	weur_wps
Fiji Hindi Wikipedia	hifwiki	asia_wps
Fijian Wikipedia	fjwiki	asia_wps
Finnish Wikibooks	fiwikibooks	weur_wps
Finnish Wikipedia	fiwiki	weur_wps
Finnish Wikiquote	fiwikiquote	weur_wps
Finnish Wikisource	fiwikisource	weur_wps
Finnish Wikiversity	fiwikiversity	weur_wps
Finnish Wiktionary	fiwiktionary	weur_wps
French Wikibooks	frwikibooks	other
French Wikinews	frwikinews	other
French Wikipedia	frwiki	frwiki
French Wikiquote	frwikiquote	other
French Wikisource	frwikisource	other
French Wikiversity	frwikiversity	other
French Wikivoyage	frwikivoyage	other
French Wiktionary	frwiktionary	other
Friulian Wikipedia	furwiki	weur_wps
Fulah Wikipedia	ffwiki	meaf_wps
Gagauz Wikipedia	gagwiki	cee_wps
Galician Wikibooks	glwikibooks	weur_wps
Galician Wikipedia	glwiki	weur_wps
Galician Wiktionary	glwiktionary	weur_wps
Gan Chinese Wikipedia	ganwiki	asia_wps
Ganda Wikipedia	lgwiki	meaf_wps
Georgian Wikibooks	kawikibooks	meaf_wps
Georgian Wikipedia	kawiki	meaf_wps
Georgian Wikiquote	kawikiquote	meaf_wps
Georgian Wiktionary	kawiktionary	meaf_wps
German Wikibooks	dewikibooks	weur_wps
German Wikinews	dewikinews	weur_wps
German Wikipedia	dewiki	dewiki
German Wikiquote	dewikiquote	weur_wps
German Wikisource	dewikisource	weur_wps
German Wikiversity	dewikiversity	weur_wps
German Wikivoyage	dewikivoyage	weur_wps
German Wiktionary	dewiktionary	weur_wps
Gilaki Wikipedia	glkwiki	meaf_wps
Goan Konkani Wikipedia	gomwiki	asia_wps
Goan Konkani Wiktionary	gomwiktionary	asia_wps
Gorontalo Wikipedia	gorwiki	asia_wps
Greek Wikibooks	elwikibooks	cee_wps
Greek Wikipedia	elwiki	cee_wps
Greek Wikiquote	elwikiquote	cee_wps
Greek Wikisource	elwikisource	cee_wps
Greek Wikivoyage	elwikivoyage	cee_wps
Greek Wiktionary	elwiktionary	cee_wps
Guarani Wikipedia	gnwiki	other
Guarani Wiktionary	gnwiktionary	other
Guianan Creole Wikipedia	gcrwiki	other
Gujarati Wikipedia	guwiki	sasia_wps
Gujarati Wikisource	guwikisource	sasia_wps
Gujarati Wiktionary	guwiktionary	sasia_wps
Haitian Creole Wikipedia	htwiki	other
Hakka Chinese Wikipedia	hakwiki	asia_wps
Hausa Wikipedia	hawiki	meaf_wps
Hausa Wiktionary	hawiktionary	meaf_wps
Hawaiian Wikipedia	hawwiki	asia_wps
Hebrew Wikibooks	hewikibooks	meaf_wps
Hebrew Wikinews	hewikinews	meaf_wps
Hebrew Wikipedia	hewiki	meaf_wps
Hebrew Wikiquote	hewikiquote	meaf_wps
Hebrew Wikisource	hewikisource	meaf_wps
Hebrew Wikivoyage	hewikivoyage	meaf_wps
Hebrew Wiktionary	hewiktionary	meaf_wps
Hindi Wikibooks	hiwikibooks	sasia_wps
Hindi Wikipedia	hiwiki	sasia_wps
Hindi Wikiquote	hiwikiquote	sasia_wps
Hindi Wikisource	hiwikisource	sasia_wps
Hindi Wikiversity	hiwikiversity	sasia_wps
Hindi Wikivoyage	hiwikivoyage	sasia_wps
Hindi Wiktionary	hiwiktionary	sasia_wps
Hungarian Wikibooks	huwikibooks	cee_wps
Hungarian Wikipedia	huwiki	cee_wps
Hungarian Wikiquote	huwikiquote	cee_wps
Hungarian Wiktionary	huwiktionary	cee_wps
Icelandic Wikibooks	iswikibooks	weur_wps
Icelandic Wikipedia	iswiki	weur_wps
Icelandic Wikisource	iswikisource	weur_wps
Icelandic Wiktionary	iswiktionary	weur_wps
Ido Wikipedia	iowiki	other
Ido Wiktionary	iowiktionary	other
Igbo Wikipedia	igwiki	meaf_wps
Iloko Wikipedia	ilowiki	asia_wps
Inari Sami Wikipedia	smnwiki	weur_wps
Indonesian Wikibooks	idwikibooks	malay_wps
Indonesian Wikipedia	idwiki	malay_wps
Indonesian Wikiquote	idwikiquote	malay_wps
Indonesian Wikisource	idwikisource	malay_wps
Indonesian Wiktionary	idwiktionary	malay_wps
Ingush Wikipedia	inhwiki	cee_wps
Interlingua Wikipedia	iawiki	other
Interlingue Wikipedia	iewiki	other
Inuktitut Wikipedia	iuwiki	other
Inuktitut Wiktionary	iuwiktionary	other
Inupiaq Wikipedia	ikwiki	other
Irish Wikipedia	gawiki	weur_wps
Italian Wikibooks	itwikibooks	weur_wps
Italian Wikinews	itwikinews	weur_wps
Italian Wikipedia	itwiki	itwiki
Italian Wikiquote	itwikiquote	weur_wps
Italian Wikisource	itwikisource	weur_wps
Italian Wikiversity	itwikiversity	weur_wps
Italian Wikivoyage	itwikivoyage	weur_wps
Italian Wiktionary	itwiktionary	weur_wps
Jamaican Patois Wikipedia	jamwiki	other
Japanese Wikibooks	jawikibooks	asia_wps
Japanese Wikipedia	jawiki	jawiki
Japanese Wikiquote	jawikiquote	asia_wps
Japanese Wikisource	jawikisource	asia_wps
Japanese Wikiversity	jawikiversity	asia_wps
Japanese Wikivoyage	jawikivoyage	asia_wps
Japanese Wiktionary	jawiktionary	asia_wps
Javanese Wikipedia	jvwiki	asia_wps
Javanese Wikisource	jvwikisource	asia_wps
Javanese Wiktionary	jvwiktionary	asia_wps
Kabardian Wikipedia	kbdwiki	cee_wps
Kabiy√® Wikipedia	kbpwiki	meaf_wps
Kabyle Wikipedia	kabwiki	meaf_wps
Kalaallisut Wikipedia	klwiki	other
Kalaallisut Wiktionary	klwiktionary	other
Kalmyk Wikipedia	xalwiki	cee_wps
Kannada Wikipedia	knwiki	sasia_wps
Kannada Wiktionary	knwiktionary	sasia_wps
Kara-Kalpak Wikipedia	kaawiki	asia_wps
Karachay-Balkar Wikipedia	krcwiki	cee_wps
Kashmiri Wikipedia	kswiki	asia_wps
Kashmiri Wiktionary	kswiktionary	asia_wps
Kashubian Wikipedia	csbwiki	cee_wps
Kazakh Wikipedia	kkwiki	asia_wps
Kazakh Wiktionary	kkwiktionary	asia_wps
Khmer Wikipedia	kmwiki	asia_wps
Khmer Wiktionary	kmwiktionary	asia_wps
Kikuyu Wikipedia	kiwiki	meaf_wps
Kinyarwanda Wikipedia	rwwiki	meaf_wps
Kinyarwanda Wiktionary	rwwiktionary	meaf_wps
Komi Wikipedia	kvwiki	cee_wps
Komi-Permyak Wikipedia	koiwiki	cee_wps
Kongo Wikipedia	kgwiki	meaf_wps
Korean Wikibooks	kowikibooks	asia_wps
Korean Wikipedia	kowiki	kowiki
Korean Wikiquote	kowikiquote	asia_wps
Korean Wikisource	kowikisource	asia_wps
Korean Wikiversity	kowikiversity	asia_wps
Korean Wiktionary	kowiktionary	asia_wps
Kotava Wikipedia	avkwiki	other
Kurdish Wikipedia	kuwiki	meaf_wps
Kurdish Wiktionary	kuwiktionary	meaf_wps
Kyrgyz Wikipedia	kywiki	asia_wps
Ladin Wikipedia	lldwiki	weur_wps
Ladino Wikipedia	ladwiki	weur_wps
Laki Wikipedia	lbewiki	cee_wps
Lao Wikipedia	lowiki	asia_wps
Lao Wiktionary	lowiktionary	asia_wps
Latgalian Wikipedia	ltgwiki	cee_wps
Latin Wikibooks	lawikibooks	weur_wps
Latin Wikipedia	lawiki	weur_wps
Latin Wikisource	lawikisource	weur_wps
Latin Wiktionary	lawiktionary	weur_wps
Latvian Wikipedia	lvwiki	cee_wps
Latvian Wiktionary	lvwiktionary	cee_wps
Lezghian Wikipedia	lezwiki	cee_wps
Ligurian Wikipedia	lijwiki	weur_wps
Ligurian Wikisource	lijwikisource	weur_wps
Limburgish Wikinews	liwikinews	weur_wps
Limburgish Wikipedia	liwiki	weur_wps
Limburgish Wikiquote	liwikiquote	weur_wps
Limburgish Wiktionary	liwiktionary	weur_wps
Lingala Wikipedia	lnwiki	meaf_wps
Lingala Wiktionary	lnwiktionary	meaf_wps
Lingua Franca Nova Wikipedia	lfnwiki	other
Lithuanian Wikibooks	ltwikibooks	cee_wps
Lithuanian Wikipedia	ltwiki	cee_wps
Lithuanian Wikiquote	ltwikiquote	cee_wps
Lithuanian Wikisource	ltwikisource	cee_wps
Lithuanian Wiktionary	ltwiktionary	cee_wps
Livvi-Karelian Wikipedia	olowiki	cee_wps
Lojban Wikipedia	jbowiki	other
Lojban Wiktionary	jbowiktionary	other
Lombard Wikipedia	lmowiki	weur_wps
Lombard Wiktionary	lmowiktionary	weur_wps
Low German Wikipedia	ndswiki	weur_wps
Low German Wiktionary	ndswiktionary	weur_wps
Low Saxon Wikipedia	nds_nlwiki	weur_wps
Lower Sorbian Wikipedia	dsbwiki	cee_wps
Luxembourgish Wikipedia	lbwiki	weur_wps
Luxembourgish Wiktionary	lbwiktionary	weur_wps
Macedonian Wikipedia	mkwiki	cee_wps
Macedonian Wikisource	mkwikisource	cee_wps
Madurese Wikipedia	madwiki	malay_wps
Maithili Wikipedia	maiwiki	sasia_wps
Malagasy Wikipedia	mgwiki	meaf_wps
Malagasy Wiktionary	mgwiktionary	meaf_wps
Malay Wikipedia	mswiki	malay_wps
Malay Wiktionary	mswiktionary	malay_wps
Malayalam Wikipedia	mlwiki	sasia_wps
Malayalam Wikisource	mlwikisource	sasia_wps
Malayalam Wiktionary	mlwiktionary	sasia_wps
Maltese Wikipedia	mtwiki	weur_wps
Manx Wikipedia	gvwiki	weur_wps
Maori Wikipedia	miwiki	asia_wps
Marathi Wikibooks	mrwikibooks	sasia_wps
Marathi Wikipedia	mrwiki	sasia_wps
Marathi Wikisource	mrwikisource	sasia_wps
Marathi Wiktionary	mrwiktionary	sasia_wps
Mazanderani Wikipedia	mznwiki	meaf_wps
MediaWiki	mediawikiwiki	other
Meetei Wiktionary	mniwiktionary	sasia_wps
Meitei Wikipedia	mniwiki	sasia_wps
Meta-Wiki	metawiki	metawiki
Min Dong Chinese Wikipedia	cdowiki	asia_wps
Min Nan Wikipedia	zh_min_nanwiki	asia_wps
Min Nan Wiktionary	zh_min_nanwiktionary	asia_wps
Minangkabau Wikipedia	minwiki	asia_wps
Minangkabau Wiktionary	minwiktionary	asia_wps
Mingrelian Wikipedia	xmfwiki	meaf_wps
Mirandese Wikipedia	mwlwiki	weur_wps
Moksha Wikipedia	mdfwiki	cee_wps
Mon Wikipedia	mnwwiki	asia_wps
Mon Wiktionary	mnwwiktionary	asia_wps
Mongolian Wikipedia	mnwiki	asia_wps
Moroccan Arabic Wikipedia	arywiki	meaf_wps
Multilingual Wikisource	sourceswiki	other
N'Ko Wikipedia	nqowiki	meaf_wps
Nauru Wikipedia	nawiki	asia_wps
Navajo Wikipedia	nvwiki	other
Neapolitan Wikipedia	napwiki	weur_wps
Neapolitan Wikisource	napwikisource	weur_wps
Nepali Wikipedia	newiki	sasia_wps
Newari Wikipedia	newwiki	asia_wps
Nias Wikipedia	niawiki	malay_wps
Nias Wiktionary	niawiktionary	malay_wps
Norfuk / Pitkern Wikipedia	pihwiki	weur_wps
Northern Frisian Wikipedia	frrwiki	weur_wps
Northern Sami Wikipedia	sewiki	weur_wps
Northern Sotho Wikipedia	nsowiki	meaf_wps
Norwegian Bokm√•l Wikipedia	nowiki	weur_wps
Norwegian Bokm√•l Wikiquote	nowikiquote	weur_wps
Norwegian Bokm√•l Wiktionary	nowiktionary	weur_wps
Norwegian Nynorsk Wikipedia	nnwiki	weur_wps
Norwegian Wikibooks	nowikibooks	weur_wps
Norwegian Wikisource	nowikisource	weur_wps
Nouormand Wikipedia	nrmwiki	weur_wps
Novial Wikipedia	novwiki	other
Nyanja Wikipedia	nywiki	meaf_wps
NƒÅhuatl Wikipedia	nahwiki	other
Occitan Wikipedia	ocwiki	weur_wps
Occitan Wiktionary	ocwiktionary	weur_wps
Old English Wikipedia	angwiki	weur_wps
Oriya Wikipedia	orwiki	sasia_wps
Oriya Wikisource	orwikisource	sasia_wps
Oriya Wiktionary	orwiktionary	sasia_wps
Oromo Wikipedia	omwiki	meaf_wps
Oromo Wiktionary	omwiktionary	meaf_wps
Ossetic Wikipedia	oswiki	cee_wps
Paiwan Wikipedia	pwnwiki	asia_wps
Palatine German Wikipedia	pflwiki	weur_wps
Pali Wikipedia	piwiki	asia_wps
Pampanga Wikipedia	pamwiki	asia_wps
Pangasinan Wikipedia	pagwiki	asia_wps
Papiamento Wikipedia	papwiki	other
Pashto Wikipedia	pswiki	sasia_wps
Persian Wikibooks	fawikibooks	meaf_wps
Persian Wikinews	fawikinews	meaf_wps
Persian Wikipedia	fawiki	meaf_wps
Persian Wikiquote	fawikiquote	meaf_wps
Persian Wikisource	fawikisource	meaf_wps
Persian Wikivoyage	fawikivoyage	meaf_wps
Persian Wiktionary	fawiktionary	meaf_wps
Picard Wikipedia	pcdwiki	weur_wps
Piedmontese Wikipedia	pmswiki	weur_wps
Piedmontese Wikisource	pmswikisource	weur_wps
Polish Wikibooks	plwikibooks	cee_wps
Polish Wikinews	plwikinews	cee_wps
Polish Wikipedia	plwiki	cee_wps
Polish Wikiquote	plwikiquote	cee_wps
Polish Wikisource	plwikisource	cee_wps
Polish Wikivoyage	plwikivoyage	cee_wps
Polish Wiktionary	plwiktionary	cee_wps
Portuguese Wikibooks	ptwikibooks	other
Portuguese Wikinews	ptwikinews	other
Portuguese Wikipedia	ptwiki	ptwiki
Portuguese Wikiquote	ptwikiquote	other
Portuguese Wikisource	ptwikisource	other
Portuguese Wikiversity	ptwikiversity	other
Portuguese Wikivoyage	ptwikivoyage	other
Portuguese Wiktionary	ptwiktionary	other
Punjabi Wikipedia	pawiki	sasia_wps
Punjabi Wikisource	pawikisource	sasia_wps
Quechua Wikipedia	quwiki	other
Quechua Wiktionary	quwiktionary	other
Romani Wikipedia	rmywiki	cee_wps
Romanian Wikinews	rowikinews	cee_wps
Romanian Wikipedia	rowiki	cee_wps
Romanian Wikisource	rowikisource	cee_wps
Romanian Wikivoyage	rowikivoyage	cee_wps
Romanian Wiktionary	rowiktionary	cee_wps
Romansh Wikipedia	rmwiki	weur_wps
Rundi Wikipedia	rnwiki	meaf_wps
Russian Wikibooks	ruwikibooks	cee_wps
Russian Wikinews	ruwikinews	cee_wps
Russian Wikipedia	ruwiki	ruwiki
Russian Wikiquote	ruwikiquote	cee_wps
Russian Wikisource	ruwikisource	cee_wps
Russian Wikiversity	ruwikiversity	cee_wps
Russian Wikivoyage	ruwikivoyage	cee_wps
Russian Wiktionary	ruwiktionary	cee_wps
Rusyn Wikipedia	ruewiki	cee_wps
Sakha Wikipedia	sahwiki	asia_wps
Sakha Wikiquote	sahwikiquote	asia_wps
Sakha Wikisource	sahwikisource	asia_wps
Sakizaya Wikipedia	szywiki	asia_wps
Samoan Wikipedia	smwiki	asia_wps
Samoan Wiktionary	smwiktionary	asia_wps
Samogitian Wikipedia	bat_smgwiki	cee_wps
Sango Wikipedia	sgwiki	meaf_wps
Sango Wiktionary	sgwiktionary	meaf_wps
Sanskrit Wikipedia	sawiki	sasia_wps
Sanskrit Wikisource	sawikisource	sasia_wps
Santali Wikipedia	satwiki	sasia_wps
Saraiki Wikipedia	skrwiki	sasia_wps
Saraiki Wiktionary	skrwiktionary	sasia_wps
Sardinian Wikipedia	scwiki	weur_wps
Saterland Frisian Wikipedia	stqwiki	weur_wps
Scots Wikipedia	scowiki	weur_wps
Scottish Gaelic Wikipedia	gdwiki	weur_wps
Seediq Wikipedia	trvwiki	asia_wps
Serbian Wikipedia	srwiki	cee_wps
Serbian Wikisource	srwikisource	cee_wps
Serbian Wiktionary	srwiktionary	cee_wps
Serbo-Croatian Wikipedia	shwiki	cee_wps
Serbo-Croatian Wiktionary	shwiktionary	cee_wps
Shan Wikipedia	shnwiki	asia_wps
Shan Wiktionary	shnwiktionary	asia_wps
Shona Wikipedia	snwiki	meaf_wps
Sicilian Wikipedia	scnwiki	weur_wps
Sicilian Wiktionary	scnwiktionary	weur_wps
Silesian Wikipedia	szlwiki	cee_wps
Simple English Wikipedia	simplewiki	weur_wps
Simple English Wiktionary	simplewiktionary	weur_wps
Sindhi Wikipedia	sdwiki	sasia_wps
Sindhi Wiktionary	sdwiktionary	sasia_wps
Sinhala Wikibooks	siwikibooks	sasia_wps
Sinhala Wikipedia	siwiki	sasia_wps
Slovak Wikibooks	skwikibooks	cee_wps
Slovak Wikipedia	skwiki	cee_wps
Slovak Wikiquote	skwikiquote	cee_wps
Slovak Wikisource	skwikisource	cee_wps
Slovak Wiktionary	skwiktionary	cee_wps
Slovenian Wikibooks	slwikibooks	cee_wps
Slovenian Wikipedia	slwiki	cee_wps
Slovenian Wikisource	slwikisource	cee_wps
Slovenian Wikiversity	slwikiversity	cee_wps
Somali Wikipedia	sowiki	meaf_wps
Somali Wiktionary	sowiktionary	meaf_wps
South Azerbaijani Wikipedia	azbwiki	meaf_wps
Southern Sotho Wikipedia	stwiki	meaf_wps
Spanish Wikibooks	eswikibooks	other
Spanish Wikinews	eswikinews	other
Spanish Wikipedia	eswiki	eswiki
Spanish Wikiquote	eswikiquote	other
Spanish Wikisource	eswikisource	other
Spanish Wikiversity	eswikiversity	other
Spanish Wikivoyage	eswikivoyage	other
Spanish Wiktionary	eswiktionary	other
Sranan Tongo Wikipedia	srnwiki	other
Sundanese Wikipedia	suwiki	asia_wps
Sundanese Wiktionary	suwiktionary	asia_wps
Swahili Wikipedia	swwiki	meaf_wps
Swahili Wiktionary	swwiktionary	meaf_wps
Swati Wikipedia	sswiki	meaf_wps
Swedish Wikibooks	svwikibooks	weur_wps
Swedish Wikipedia	svwiki	weur_wps
Swedish Wikiquote	svwikiquote	weur_wps
Swedish Wikisource	svwikisource	weur_wps
Swedish Wikivoyage	svwikivoyage	weur_wps
Swedish Wiktionary	svwiktionary	weur_wps
Tachelhit Wikipedia	shiwiki	meaf_wps
Tagalog Wikipedia	tlwiki	asia_wps
Tagalog Wiktionary	tlwiktionary	asia_wps
Tahitian Wikipedia	tywiki	asia_wps
Tajik Wikipedia	tgwiki	asia_wps
Tajik Wiktionary	tgwiktionary	asia_wps
Tamil Wikibooks	tawikibooks	sasia_wps
Tamil Wikipedia	tawiki	sasia_wps
Tamil Wikiquote	tawikiquote	sasia_wps
Tamil Wikisource	tawikisource	sasia_wps
Tamil Wiktionary	tawiktionary	sasia_wps
Tarand√≠ne Wikipedia	roa_tarawiki	weur_wps
Tatar Wikipedia	ttwiki	cee_wps
Telugu Wikibooks	tewikibooks	sasia_wps
Telugu Wikipedia	tewiki	sasia_wps
Telugu Wikisource	tewikisource	sasia_wps
Telugu Wiktionary	tewiktionary	sasia_wps
Tetum Wikipedia	tetwiki	asia_wps
Thai Wikibooks	thwikibooks	asia_wps
Thai Wikipedia	thwiki	asia_wps
Thai Wikiquote	thwikiquote	asia_wps
Thai Wikisource	thwikisource	asia_wps
Thai Wiktionary	thwiktionary	asia_wps
Tibetan Wikipedia	bowiki	asia_wps
Tigrinya Wikipedia	tiwiki	meaf_wps
Tok Pisin Wikipedia	tpiwiki	asia_wps
Tok Pisin Wiktionary	tpiwiktionary	asia_wps
Tongan Wikipedia	towiki	asia_wps
Tsonga Wikipedia	tswiki	meaf_wps
Tswana Wikipedia	tnwiki	meaf_wps
Tulu Wikipedia	tcywiki	sasia_wps
Tumbuka Wikipedia	tumwiki	meaf_wps
Turkish Wikibooks	trwikibooks	meaf_wps
Turkish Wikipedia	trwiki	meaf_wps
Turkish Wikiquote	trwikiquote	meaf_wps
Turkish Wikisource	trwikisource	meaf_wps
Turkish Wikivoyage	trwikivoyage	meaf_wps
Turkish Wiktionary	trwiktionary	meaf_wps
Turkmen Wikipedia	tkwiki	asia_wps
Turkmen Wiktionary	tkwiktionary	asia_wps
Tuvinian Wikipedia	tyvwiki	asia_wps
Twi Wikipedia	twwiki	meaf_wps
Udmurt Wikipedia	udmwiki	cee_wps
Ukrainian Wikibooks	ukwikibooks	cee_wps
Ukrainian Wikinews	ukwikinews	cee_wps
Ukrainian Wikipedia	ukwiki	cee_wps
Ukrainian Wikiquote	ukwikiquote	cee_wps
Ukrainian Wikisource	ukwikisource	cee_wps
Ukrainian Wikivoyage	ukwikivoyage	cee_wps
Ukrainian Wiktionary	ukwiktionary	cee_wps
Upper Sorbian Wikipedia	hsbwiki	cee_wps
Urdu Wikipedia	urwiki	sasia_wps
Urdu Wiktionary	urwiktionary	sasia_wps
Uyghur Wikipedia	ugwiki	asia_wps
Uzbek Wikipedia	uzwiki	asia_wps
Uzbek Wiktionary	uzwiktionary	asia_wps
Venda Wikipedia	vewiki	meaf_wps
Venetian Wikipedia	vecwiki	weur_wps
Venetian Wikisource	vecwikisource	weur_wps
Veps Wikipedia	vepwiki	cee_wps
Vietnamese Wikibooks	viwikibooks	asia_wps
Vietnamese Wikipedia	viwiki	viwiki
Vietnamese Wikiquote	viwikiquote	asia_wps
Vietnamese Wikisource	viwikisource	asia_wps
Vietnamese Wikivoyage	viwikivoyage	asia_wps
Vietnamese Wiktionary	viwiktionary	asia_wps
Volap√ºk Wikipedia	vowiki	other
Volap√ºk Wiktionary	vowiktionary	other
V√µro Wikipedia	fiu_vrowiki	meaf_wps
Walloon Wikipedia	wawiki	weur_wps
Walloon Wikisource	wawikisource	weur_wps
Walloon Wiktionary	wawiktionary	weur_wps
Waray Wikipedia	warwiki	asia_wps
Welsh Wikipedia	cywiki	weur_wps
Welsh Wikiquote	cywikiquote	weur_wps
Welsh Wikisource	cywikisource	weur_wps
Welsh Wiktionary	cywiktionary	weur_wps
West Flemish Wikipedia	vlswiki	weur_wps
Western Armenian Wikipedia	hywwiki	meaf_wps
Western Frisian Wikipedia	fywiki	weur_wps
Western Mari Wikipedia	mrjwiki	cee_wps
Western Punjabi Wikipedia	pnbwiki	asia_wps
Wikidata	wikidatawiki	wikidata
Wikimedia Commons	commonswiki	commons
Wikimedia Incubator	incubatorwiki	other
Wikispecies	specieswiki	other
Wolof Wikipedia	wowiki	meaf_wps
Wolof Wiktionary	wowiktionary	meaf_wps
Wu Chinese Wikipedia	wuuwiki	asia_wps
Xhosa Wikipedia	xhwiki	meaf_wps
Yiddish Wikipedia	yiwiki	weur_wps
Yiddish Wiktionary	yiwiktionary	weur_wps
Yoruba Wikipedia	yowiki	meaf_wps
Zazaki Wikipedia	diqwiki	meaf_wps
Zazaki Wiktionary	diqwiktionary	meaf_wps
Zeelandic Wikipedia	zeawiki	weur_wps
Zhuang Wikipedia	zawiki	asia_wps
Zulu Wikipedia	zuwiki	meaf_wps
Zulu Wiktionary	zuwiktionary	meaf_wps
